*          
###########
#000K00000#
#000000000#
#00TJ00T00#
#0000000F0#
#000000000#
#TW0000T00#
#000000000#
#00T0K000D#
#N0T0000#5#
###########