(          
###########
#000K0T00N#
#0000TTTT0#
#00T000T00#
#0000000F0#
#000000000#
#TW0000T00#
#000000000#
#00T000000#
#W0T00F000#
###########