-          
###########
#0000000#2#
#000K000#D#
#0000000J0#
#0000000F0#
#000000000#
#T00000000#
#000000000#
#000000000#
#000000000#
###########