###########
#4D0#000#0#
###K0#0#J0#
#000000#T0#
#00J000#F0#
#0F0#00#00#
#0#0000#00#
#F00000#0K#
#000W0W##D#
#000000##3#
###########