###########
#000000000#
#0#######0#
#000J#00F0#
#0#######0#
#0#######0#
#0#######0#
#0000#0000#
#D#######0#
#2#T00K000#
###########