%          
###########
#N00K00000#
#000000000#
#00T000T00#
#0000000F0#
#000000000#
#TW0000T00#
#000000000#
#00T000000#
#N0T00000N#
###########